{
    "levelNr": "1",
    "levelTitle": "A New Rise",
    "levelPassword":"begin",
    "backgroundType": "galaxy1",
    "levelDefinition": [
        "------------------------------",
        "------------------------------",
        "------------------------------",
        "------------------------------",
        "------------------------------",
        "------------------------------",
        "------------------------------",
        "------------------------------",
        "--------------------FFF-------",
        "------111111111111111EF-------",
        "------1-------------FFF-------",
        "-S11111-----------------------",
        "------------------------------",
        "------------------------------",
        "------------------------------",
        "------------------------------",
        "------------------------------",
        "------------------------------",
        "------------------------------",
        "------------------------------"
    ]
}
